0 7 7 7 7 7 7 7 7 7 7 7 7 7 7 7 7 7 7 1
4 13 13 13 13 13 13 13 13 13 13 13 13 13 13 13 13 13 13 6
4 13 13 13 13 13 13 13 13 13 13 13 13 13 13 13 13 13 13 6
4 13 13 13 13 13 13 13 13 13 13 13 13 13 13 13 13 13 13 6
4 13 13 13 13 13 13 13 13 13 13 13 13 13 13 13 13 13 13 6
4 13 13 13 13 13 13 13 13 13 13 13 13 13 13 13 13 13 13 6
4 13 13 13 13 13 13 13 13 13 13 13 13 13 13 13 13 13 13 6
4 13 13 13 13 13 13 13 13 13 13 13 13 13 13 13 13 13 13 6
4 13 13 13 13 13 13 13 13 13 13 13 13 13 13 13 13 13 13 6
4 13 13 13 13 13 13 13 13 13 13 13 13 13 13 13 13 13 13 6
4 13 13 13 13 13 13 13 13 13 13 13 13 13 13 13 13 13 13 6
4 13 13 13 13 13 13 13 13 13 13 13 13 13 13 13 13 13 13 6
4 13 13 13 13 13 13 13 13 13 13 13 13 13 13 13 13 13 13 6
4 13 13 13 13 13 13 13 13 13 13 13 13 13 13 13 13 13 13 6
4 13 13 13 13 13 13 13 13 13 13 13 13 13 13 13 13 13 13 6
3 5 5 5 5 5 5 5 5 5 5 5 5 5 5 5 5 5 5 2
