0 7 7 7 7 8 7 8 7 7 8 7 7 8 7 7 7 7 7 1
4 13 13 13 13 16 13 37 13 13 16 13 13 37 13 13 13 13 13 6
4 13 17 13 13 13 13 16 13 13 13 13 13 16 13 13 17 13 13 6
4 13 37 13 13 17 13 13 13 13 17 13 13 13 13 13 37 13 13 6
3 5 10 5 5 10 5 5 5 5 10 5 5 5 5 5 10 5 5 2
